111111111111111111111111111111
111010000001000001000000000001
101011010101011101011111011101
100011010101010001000001000101
111011000101010111010111111101
100000010100010101010000000101
101101010101010100011111110101
101101011111010101111000000101
101101000001010101000111111001
101101111101010110010001000011
111101000101010110111101011001
100101101101000110110100011011
101101101101010100000111010001
100001000101110001011101010111
101101010100001101000100110001
100101010111101101111110101011
111101001100000100000000101011
100001101011110111111111100001
110100001010000100000001101101
100110100010111101010110000101
101010111100000101010111111101
101011100011011101010111010101
100010001111010001010110000101
101011100000000101011010101101
101100101101111111011010111101
101101101101000000000010000001
101000101001101111111000111101
101010101111000000001111100101
101110101001111111100000101101
100000101101101010001110100001
101110100100000011101010101101
101010110011011000101010100101
101010111010011101101010110101
100010111011100000000010000101
110110111000111111010111111101
100010000010000001010100000101
101110111111111101010101010101
101000100011010101010101010101
101010101100010100010111000101
101111101101110001110000110001
101000101000000110000110000101
101010101011101100110011110101
100010100010001101111000010101
111110111110111000000111001101
100010100000100011110101101101
101000110111111110000101000001
101011100100000010110001110111
101010101101111110111111010001
101010100001000001000000010111
110000101111101101110111000101
110111100010001100000101110101
110100011010100011110101011101
100001011010111110111101000001
101101011010100010000001110101
101111010000101011110101000101
100001011111101000000101101101
101111000001001011110111001001
101010101101111011110100011011
101010101000001011100001111001
101010001010100000011100001011
101010111010110111010111111001
101000001010011111010100001101
101111101011000000110111101101
100000101001011110110100001101
101110101101010010000011100001
101000101001011010111000011101
101011101101001010001011010101
101011001001101011111111010001
101000111101000010000000010111
101110100001011010111111010001
101010111011001000100000010101
101010101111111111111111010101
101010100000000000000101010101
101010001111111111110101010111
100010100000010000010100010001
111110111110110111010101110101
100010000010111101010101000101
101011101100000101010011110111
101000000001110100011000000001
111111111111111111111111111111
