111111111111111111111111111111
100000000000100010000101111101
101101111011101011010000000001
100101111000001010011111110101
111100000111111011100000000101
101111111110001000101011110101
100000000000101110111001010101
101101101110101110000011010101
101101100010100001101010010101
101101001011111111111110110101
100111111000000000000000010001
101000000111111010101111000111
101010110110100010101001111101
101110100010111011111100000001
100000101010000000000101111101
111011111011111110111000000101
100000000010000100101111111101
101111111010110111100000000001
101011101010100000101011111101
101000001010111110101010000001
101110101010000010101011111011
101000101011011110101000010001
101011111011000000101101010101
101000000000011110101101010111
101011111101100010100001010001
101000010001101000111101111101
101111011101101010100001000001
101000001000101010111101110101
101111111010111010000101010101
100000001010100010110100010101
101011011000111010010111010101
101011111010001010110011111101
101000001010101010001000100001
101011101100111101101010111101
101011101001000001111110111101
101011101011111100000000111101
101101101011100001111111000001
101100001000011011111000111011
100101011111111000000010100011
101101000000000011111110101011
101011111111111000000111101001
101011000001010011110000001011
101000011111011111010111101011
101011000011000000010000101011
100010011100011111111111101101
101010111111010000000000101101
101010001101011111011101101001
101010100001000000000100001101
101111111101110111111110111101
100000010101010110000000000001
101101110101010111011011111101
101000010101010101110010000101
111110110101010100000110110101
100000010101000101111111110101
101111110101110101000000000001
101000000100000101111111111101
101110111101110101000100000101
101010000001010101010111011101
101011101111010100010101000001
101000001011010111110001010111
101101111010010100011101010001
101100000010110111010001011011
101101011000010000010111111001
101101111111110111100001000011
101100000000010000011101101011
101101111011111111010101101011
101101101010000000000100101011
101101101001111010111110101101
101000101011000010000010101101
101111101011011111111010101001
101000001000000000111110101101
101111101111111110100010101001
101000100000011111101110101011
100010001111010000000000001001
101110111111000101111111101101
101011100000111101111111101101
100010001110100101111111101001
111010111000101111111111101101
100000100010100000000000000001
111111111111111111111111111111
