бсбсбсбсбсбсбсбсбсбсбсбсбсбсбсбсбсбсбсбсбсбсбсбсбсбсбсбсбсбс
бс  бс  бсбс  бсбс                    бсбсбсбс            бс
бс        бс      бсбс  бсбс  бсбсбс            бсбсбсбс  бс
бсбсбсбс  бс  бс  бсбс  бсбс  бс  бсбс  бсбсбсбс          бс
бсбс  бс  бсбсбс  бс      бс  бс    бс  бс  бсбс  бсбсбсбсбс
бс    бс          бсбсбс      бс  бсбс  бс  бс    бс      бс
бс  бсбсбсбсбсбс  бс  бсбсбс      бсбс  бс  бсбс    бсбс  бс
бс            бс  бс  бс  бс  бс    бс  бс  бсбсбс  бсбс  бс
бсбс  бс  бс  бс  бс      бс  бсбсбсбс  бс  бс            бс
бсбс  бс  бс  бс  бсбс  бсбс  бс        бс      бсбсбсбс  бс
бсбс  бс  бс  бс  бсбс        бс  бсбсбсбс  бсбсбсбсбсбс  бс
бсбс  бс  бс  бс  бсбс  бсбсбсбс        бс      бс  бсбс  бс
бсбс  бс  бс  бс  бс    бс        бс  бсбс  бс  бс    бс  бс
бсбс  бс  бсбсбс  бсбсбсбсбс  бс  бс  бс    бс  бсбс  бс  бс
бсбс                          бсбсбсбсбс  бсбсбс      бс  бс
бс    бсбсбсбсбсбсбсбсбсбсбсбс            бс  бс  бсбсбс  бс
бс  бс                  бс      бсбсбсбсбсбс              бс
бс  бсбсбсбсбс  бс  бсбсбс  бс  бс        бс  бсбсбсбсбс  бс
бс              бс  бс      бс  бс  бсбсбс                бс
бсбс  бсбсбсбсбсбс  бс  бс  бс  бс  бсбсбс  бсбсбсбсбсбсбсбс
бс            бсбс  бсбсбсбсбс  бс  бсбсбс                бс
бс  бсбсбсбс    бс              бс          бсбсбсбсбсбс  бс
бс  бс  бсбс  бсбс  бсбсбсбсбс  бсбс  бсбсбс          бс  бс
бс  бс          бс  бс      бс  бсбс  бс  бс  бс  бс  бс  бс
бс  бс  бс  бс  бс  бсбсбс  бс  бсбс  бс  бсбсбс  бс  бс  бс
бс  бсбсбс  бс  бс  бсбс    бс  бсбс  бс          бс      бс
бс      бс  бс            бсбс    бс  бсбсбсбс  бсбсбсбс  бс
бсбсбс  бс  бсбсбсбсбсбс  бсбсбсбсбс                  бс  бс
бс      бс  бс      бсбсбсбс        бсбсбсбсбсбсбсбс  бс  бс
бс  бсбсбс  бс  бс            бсбсбс              бс  бс  бс
бс          бсбсбсбс  бсбсбс  бс  бс  бс  бсбсбсбс  бсбс  бс
бсбсбсбсбс            бс  бс  бс  бс  бс                  бс
бс        бсбсбсбсбсбсбс  бс  бс      бс  бсбс  бсбсбс  бсбс
бс  бсбсбсбсбс        бс  бс  бсбсбсбс      бс  бс  бс  бсбс
бс            бс  бс  бс  бс  бс        бс  бс  бс  бс  бсбс
бс  бсбсбсбсбсбс  бс            бсбсбс  бс  бс      бс  бсбс
бс  бс            бс  бсбсбсбс  бс  бс  бс  бсбсбс  бс    бс
бс  бс  бсбсбс  бсбс  бс  бсбс      бс  бс  бс      бсбс  бс
бс  бс  бс  бс  бсбс      бс  бсбс  бс  бс  бс  бс    бс  бс
бс      бс    бсбс  бсбс  бс  бс    бс  бс  бс  бсбсбсбс  бс
бс  бсбсбсбс  бсбс  бсбс  бс  бсбсбс  бсбс  бс  бс        бс
бс  бс  бсбс  бсбс            бс  бс  бсбс  бс  бсбсбсбс  бс
бс      бс      бс  бсбсбсбс  бс  бс        бс  бс    бс  бс
бс  бс  бс  бс  бс        бс  бс  бс  бсбс  бс  бсбс  бс  бс
бс  бс  бс  бсбсбс  бс  бсбс  бс  бс  бсбс  бс  бсбс  бс  бс
бс      бс          бс  бсбс  бс      бс              бс  бс
бсбсбсбс  бс  бсбсбсбс    бс  бсбс  бсбсбсбсбсбсбсбс      бс
бс    бс  бс  бс      бсбсбс                    бсбс  бсбсбс
бсбс          бс  бсбсбс  бсбсбсбсбсбс  бсбсбсбс          бс
бсбс  бсбсбсбсбс  бс      бс            бс    бс  бсбсбсбсбс
бсбс  бс      бс      бс  бсбсбсбсбсбс  бсбс  бс  бс  бс  бс
бсбс  бс  бс      бсбсбс                      бс      бс  бс
бс        бс  бс  бс      бсбсбсбсбс  бсбсбсбсбсбсбс      бс
бс  бсбс  бс  бс  бс  бс  бс  бс  бс  бс  бс        бсбс  бс
бс  бсбс  бс  бс  бс  бс  бс      бс  бс      бсбс  бсбс  бс
бс  бсбс  бс  бс  бс  бс  бсбс  бсбс      бсбсбс    бсбс  бс
бс  бсбс  бс  бс  бс  бс  бсбс  бсбс  бсбсбс  бсбс        бс
бс  бс    бс  бс      бс  бс      бс  бс  бсбс  бсбсбсбсбсбс
бс  бсбсбсбсбсбсбсбс  бс  бсбсбс  бс  бс    бс  бс    бс  бс
бс  бс            бс  бс          бс  бс  бсбс  бсбс      бс
бс  бсбсбсбсбсбс      бс  бсбс  бсбс  бс  бсбс  бсбсбсбс  бс
бс  бс        бс  бсбс      бс  бс    бс                  бс
бс  бс  бсбс  бс  бсбс  бсбсбсбсбсбсбсбсбсбс  бсбсбсбсбс  бс
бс  бс        бс  бс            бс        бс      бс      бс
бс  бс  бсбс      бс  бсбсбсбс  бсбс  бс  бсбсбс  бсбсбсбсбс
бс  бсбсбсбс  бсбсбс  бс    бс        бс    бс            бс
бс      бсбс  бсбс    бсбс  бсбсбсбс  бсбс  бс  бс  бс  бсбс
бс  бс  бс  бсбс    бс            бс  бсбс  бсбсбс  бс    бс
бс  бс            бсбс  бсбсбсбс  бс  бс          бсбсбс  бс
бс      бсбсбс  бс  бс  бсбсбсбс  бс  бсбсбсбсбс  бс  бс  бс
бсбсбсбсбс      бс  бс  бсбсбсбс  бс                  бс  бс
бс        бсбсбсбс  бс  бсбсбсбс  бсбсбсбс  бсбсбсбсбсбс  бс
бс  бсбс        бс  бс  бсбсбсбс  бс        бс            бс
бс    бсбсбсбсбсбс  бс      бсбс  бсбс  бсбсбс  бсбс  бсбсбс
бсбс                бс  бсбс            бс        бс      бс
бсбс  бсбсбсбсбсбс  бс  бсбсбсбсбс  бсбсбсбс  бсбсбсбсбс  бс
бсбс  бсбсбсбсбсбс  бс  бсбсбс      бс        бс          бс
бсбс  бсбсбсбсбсбс            бсбсбсбсбсбсбсбсбс  бсбсбс  бс
бс                  бсбс  бс                        бсбс  бс
бсбсбсбсбсбсбсбсбсбсбсбсбсбсбсбсбсбсбсбсбсбсбсбсбсбсбсбсбсбс
