бсбсбсбсбсбсбсбсбсбсбсбсбсбсбсбсбсбсбсбсбсбсбсбсбсбсбсбсбсбс
бс                      бс      бс        бс  бсбсбсбсбс  бс
бс  бсбс  бсбсбсбс  бсбсбс  бс  бсбс  бс                  бс
бс    бс  бсбсбсбс          бс  бс    бсбсбсбсбсбсбс  бс  бс
бсбсбсбс          бсбсбсбсбсбс  бсбсбс                бс  бс
бс  бсбсбсбсбсбсбсбсбс      бс      бс  бс  бсбсбсбс  бс  бс
бс                      бс  бсбсбс  бсбсбс    бс  бс  бс  бс
бс  бсбс  бсбс  бсбсбс  бс  бсбсбс          бсбс  бс  бс  бс
бс  бсбс  бсбс      бс  бс        бсбс  бс  бс    бс  бс  бс
бс  бсбс  бс    бс  бсбсбсбсбсбсбсбсбсбсбсбсбс  бсбс  бс  бс
бс    бсбсбсбсбсбс                                бс      бс
бс  бс            бсбсбсбсбсбс  бс  бс  бсбсбсбс      бсбсбс
бс  бс  бс  бсбс  бсбс  бс      бс  бс  бс    бсбсбсбсбс  бс
бс  бсбсбс  бс      бс  бсбсбс  бсбсбсбсбсбс              бс
бс          бс  бс  бс                    бс  бсбсбсбсбс  бс
бсбсбс  бсбсбсбсбс  бсбсбсбсбсбсбс  бсбсбс            бс  бс
бс                  бс        бс    бс  бсбсбсбсбсбсбсбс  бс
бс  бсбсбсбсбсбсбс  бс  бсбс  бсбсбсбс                    бс
бс  бс  бсбсбс  бс  бс  бс          бс  бс  бсбсбсбсбсбс  бс
бс  бс          бс  бс  бсбсбсбсбс  бс  бс  бс            бс
бс  бсбсбс  бс  бс  бс          бс  бс  бс  бсбсбсбсбс  бсбс
бс  бс      бс  бс  бсбс  бсбсбсбс  бс  бс        бс      бс
бс  бс  бсбсбсбсбс  бсбс            бс  бсбс  бс  бс  бс  бс
бс  бс                    бсбсбсбс  бс  бсбс  бс  бс  бсбсбс
бс  бс  бсбсбсбсбсбс  бсбс      бс  бс        бс  бс      бс
бс  бс        бс      бсбс  бс      бсбсбсбс  бсбсбсбсбс  бс
бс  бсбсбсбс  бсбсбс  бсбс  бс  бс  бс        бс          бс
бс  бс          бс      бс  бс  бс  бсбсбсбс  бсбсбс  бс  бс
бс  бсбсбсбсбсбсбс  бс  бсбсбс  бс        бс  бс  бс  бс  бс
бс              бс  бс  бс      бс  бсбс  бс      бс  бс  бс
бс  бс  бсбс  бсбс      бсбсбс  бс    бс  бсбсбс  бс  бс  бс
бс  бс  бсбсбсбсбс  бс      бс  бс  бсбс    бсбсбсбсбсбс  бс
бс  бс          бс  бс  бс  бс  бс      бс      бс        бс
бс  бс  бсбсбс  бсбс    бсбсбсбс  бсбс  бс  бс  бсбсбсбс  бс
бс  бс  бсбсбс  бс    бс          бсбсбсбсбсбс  бсбсбсбс  бс
бс  бс  бсбсбс  бс  бсбсбсбсбсбс                бсбсбсбс  бс
бс  бсбс  бсбс  бс  бсбсбс        бсбсбсбсбсбсбс          бс
бс  бсбс        бс        бсбс  бсбсбсбсбс      бсбсбс  бсбс
бс    бс  бс  бсбсбсбсбсбсбсбс              бс  бс      бсбс
бс  бсбс  бс                    бсбсбсбсбсбсбс  бс  бс  бсбс
бс  бс  бсбсбсбсбсбсбсбсбсбсбс            бсбсбсбс  бс    бс
бс  бс  бсбс          бс  бс    бсбсбсбс            бс  бсбс
бс  бс        бсбсбсбсбс  бсбсбсбсбс  бс  бсбсбсбс  бс  бсбс
бс  бс  бсбс        бсбс              бс        бс  бс  бсбс
бс      бс    бсбсбс      бсбсбсбсбсбсбсбсбсбсбсбс  бсбс  бс
бс  бс  бс  бсбсбсбсбсбс  бс                    бс  бсбс  бс
бс  бс  бс      бсбс  бс  бсбсбсбсбс  бсбсбс  бсбс  бс    бс
бс  бс  бс  бс        бс                  бс        бсбс  бс
бс  бсбсбсбсбсбсбсбс  бсбсбс  бсбсбсбсбсбсбсбс  бсбсбсбс  бс
бс            бс  бс  бс  бс  бсбс                        бс
бс  бсбс  бсбсбс  бс  бс  бс  бсбсбс  бсбс  бсбсбсбсбсбс  бс
бс  бс        бс  бс  бс  бс  бс  бсбсбс    бс        бс  бс
бсбсбсбсбс  бсбс  бс  бс  бс  бс          бсбс  бсбс  бс  бс
бс            бс  бс  бс      бс  бсбсбсбсбсбсбсбсбс  бс  бс
бс  бсбсбсбсбсбс  бс  бсбсбс  бс  бс                      бс
бс  бс            бс          бс  бсбсбсбсбсбсбсбсбсбсбс  бс
бс  бсбсбс  бсбсбсбс  бсбсбс  бс  бс      бс          бс  бс
бс  бс  бс            бс  бс  бс  бс  бс  бсбсбс  бсбсбс  бс
бс  бс  бсбсбс  бсбсбсбс  бс  бс      бс  бс  бс          бс
бс  бс          бс  бсбс  бс  бсбсбсбсбс      бс  бс  бсбсбс
бс  бсбс  бсбсбсбс  бс    бс  бс      бсбсбс  бс  бс      бс
бс  бсбс            бс  бсбс  бсбсбс  бс      бс  бсбс  бсбс
бс  бсбс  бс  бсбс        бс          бс  бсбсбсбсбсбс    бс
бс  бсбс  бсбсбсбсбсбсбсбсбс  бсбсбсбс        бс        бсбс
бс  бсбс                  бс          бсбсбс  бсбс  бс  бсбс
бс  бсбс  бсбсбсбс  бсбсбсбсбсбсбсбс  бс  бс  бсбс  бс  бсбс
бс  бсбс  бсбс  бс  бс                    бс    бс  бс  бсбс
бс  бсбс  бсбс  бс    бсбсбсбс  бс  бсбсбсбсбс  бс  бсбс  бс
бс  бс      бс  бс  бсбс        бс          бс  бс  бсбс  бс
бс  бсбсбсбсбс  бс  бсбс  бсбсбсбсбсбсбсбс  бс  бс  бс    бс
бс  бс          бс                  бсбсбсбсбс  бс  бсбс  бс
бс  бсбсбсбсбс  бсбсбсбсбсбсбсбсбс  бс      бс  бс  бс    бс
бс  бс      бс            бсбсбсбсбсбс  бсбсбс  бс  бс  бсбс
бс      бс      бсбсбсбс  бс                        бс    бс
бс  бсбсбс  бсбсбсбсбсбс      бс  бсбсбсбсбсбсбсбс  бсбс  бс
бс  бс  бсбсбс          бсбсбсбс  бсбсбсбсбсбсбсбс  бсбс  бс
бс      бс      бсбсбс  бс    бс  бсбсбсбсбсбсбсбс  бс    бс
бсбсбс  бс  бсбсбс      бс  бсбсбсбсбсбсбсбсбсбсбс  бсбс  бс
бс          бс      бс  бс                                бс
бсбсбсбсбсбсбсбсбсбсбсбсбсбсбсбсбсбсбсбсбсбсбсбсбсбсбсбсбсбс
