111111111111111111111111111111
101011011000000000011110000001
100001000110110111000000111101
111101010110110101101111000001
110101110100010100101011011111
100100000111000101101010010001
101111110101110001101011001101
100000010101010100101011101101
110101010100010111101010000001
110101010110110100001000111101
110101010110000101111011111101
110101010110111100001000101101
110101010100100001011010100101
110101110111110101010010110101
110000000000000111110111000101
100111111111111000000101011101
101000000000100011111100000001
101111101011101010000101111101
100000001010001010111000000001
110111111010101010111011111111
100000011011111010111000000001
101111001000000010000011111101
101011011011111011011100000101
101000001010001011010101010101
101010101011101011010111010101
101110101011001011010000010001
100010100000011001011110111101
111010111111011111000000000101
100010100011110000111111110101
101110101000000111000000010101
100000111101110101010111101101
111110000001010101010000000001
100001111111010100010110111011
101111100001010111100010101011
100000010101010100001010101011
101111110100000011101010001011
101000000101111010101011101001
101011101101011000101010001101
101010101100010110101010100101
100010011011010100101010111101
101111011011010111011010100001
101011011000000101011010111101
100010001011110101000010100101
101010101000010101011010110101
101010111010110101011010110101
100010000010110100010000000101
111101011110010110111111110001
100101010001110000000000110111
110000010111011111101111000001
110111110100010000001001011111
110100010001011111101101010101
110101000111000000000001000101
100001010100011111011111110001
101101010101010101010100001101
101101010101010001010001101101
101101010101011011000111001101
101101010101011011011101100001
101001010001010001010110111111
101111111101011101010010100101
101000000101000001010110110001
101111110001011011010110111101
101000010110001010010000000001
101011010110111111111101111101
101000010100000010000100010001
101011000101111011010111011111
101111011101001000010010000001
100011011001101111011010101011
101010110010000001011011101001
101000000110111101010000011101
100011101010111101011111010101
111110001010111101000000000101
100001111010111101111011111101
101100001010111101000010000001
100111111010001101101110110111
110000000010110000001000010001
110111111010111110111101111101
110111111010111000100001000001
110111111000000111111111011101
100000000011010000000000001101
111111111111111111111111111111
