бсбсбсбсбсбсбсбсбсбсбсбсбсбсбсбсбсбсбсбсбсбсбсбсбсбсбсбсбсбс
бсбсбс  бс            бс          бс                      бс
бс  бс  бсбс  бс  бс  бс  бсбсбс  бс  бсбсбсбсбс  бсбсбс  бс
бс      бсбс  бс  бс  бс  бс      бс          бс      бс  бс
бсбсбс  бсбс      бс  бс  бс  бсбсбс  бс  бсбсбсбсбсбсбс  бс
бс            бс  бс      бс  бс  бс  бс              бс  бс
бс  бсбс  бс  бс  бс  бс  бс  бс      бсбсбсбсбсбсбс  бс  бс
бс  бсбс  бс  бсбсбсбсбс  бс  бс  бсбсбсбс            бс  бс
бс  бсбс  бс          бс  бс  бс  бс      бсбсбсбсбсбс    бс
бс  бсбс  бсбсбсбсбс  бс  бс  бсбс    бс      бс        бсбс
бсбсбсбс  бс      бс  бс  бс  бсбс  бсбсбсбс  бс  бсбс    бс
бс    бс  бсбс  бсбс  бс      бсбс  бсбс  бс      бсбс  бсбс
бс  бсбс  бсбс  бсбс  бс  бс  бс          бсбсбс  бс      бс
бс        бс      бс  бсбсбс      бс  бсбсбс  бс  бс  бсбсбс
бс  бсбс  бс  бс  бс        бсбс  бс      бс    бсбс      бс
бс    бс  бс  бс  бсбсбсбс  бсбс  бсбсбсбсбсбс  бс  бс  бсбс
бсбсбсбс  бс    бсбс          бс                бс  бс  бсбс
бс        бсбс  бс  бсбсбсбс  бсбсбсбсбсбсбсбсбсбс        бс
бсбс  бс        бс  бс        бс              бсбс  бсбс  бс
бс    бсбс  бс      бс  бсбсбсбс  бс  бс  бсбс        бс  бс
бс  бс  бс  бсбсбсбс          бс  бс  бс  бсбсбсбсбсбсбс  бс
бс  бс  бсбсбс      бсбс  бсбсбс  бс  бс  бсбсбс  бс  бс  бс
бс      бс      бсбсбсбс  бс      бс  бс  бсбс        бс  бс
бс  бс  бсбсбс                бс  бс  бсбс  бс  бс  бсбс  бс
бс  бсбс    бс  бсбс  бсбсбсбсбсбсбс  бсбс  бс  бсбсбсбс  бс
бс  бсбс  бсбс  бсбс  бс                    бс            бс
бс  бс      бс  бс    бсбс  бсбсбсбсбсбсбс      бсбсбсбс  бс
бс  бс  бс  бс  бсбсбсбс                бсбсбсбсбс    бс  бс
бс  бсбсбс  бс  бс    бсбсбсбсбсбсбсбс          бс  бсбс  бс
бс          бс  бсбс  бсбс  бс  бс      бсбсбс  бс        бс
бс  бсбсбс  бс    бс            бсбсбс  бс  бс  бс  бсбс  бс
бс  бс  бс  бсбс    бсбс  бсбс      бс  бс  бс  бс    бс  бс
бс  бс  бс  бсбсбс  бс    бсбсбс  бсбс  бс  бс  бсбс  бс  бс
бс      бс  бсбсбс  бсбсбс                  бс        бс  бс
бсбс  бсбс  бсбсбс      бсбсбсбсбсбс  бс  бсбсбсбсбсбсбс  бс
бс      бс          бс            бс  бс  бс          бс  бс
бс  бсбсбс  бсбсбсбсбсбсбсбсбсбс  бс  бс  бс  бс  бс  бс  бс
бс  бс      бс      бсбс  бс  бс  бс  бс  бс  бс  бс  бс  бс
бс  бс  бс  бс  бсбс      бс  бс      бс  бсбсбс      бс  бс
бс  бсбсбсбсбс  бсбс  бсбсбс      бсбсбс        бсбс      бс
бс  бс      бс  бс            бсбс        бсбс        бс  бс
бс  бс  бс  бс  бс  бсбсбс  бсбс    бсбс    бсбсбсбс  бс  бс
бс      бс  бс      бс      бсбс  бсбсбсбс        бс  бс  бс
бсбсбсбсбс  бсбсбсбсбс  бсбсбс            бсбсбс    бсбс  бс
бс      бс  бс          бс      бсбсбсбс  бс  бсбс  бсбс  бс
бс  бс      бсбс  бсбсбсбсбсбсбсбс        бс  бс          бс
бс  бс  бсбсбс    бс            бс  бсбс      бсбсбс  бсбсбс
бс  бс  бс  бс  бсбс  бсбсбсбсбсбс  бсбсбсбсбсбс  бс      бс
бс  бс  бс  бс        бс          бс              бс  бсбсбс
бсбс        бс  бсбсбсбсбс  бсбс  бсбсбс  бсбсбс      бс  бс
бсбс  бсбсбсбс      бс      бсбс          бс  бсбсбс  бс  бс
бсбс  бс      бсбс  бс  бс      бсбсбсбс  бс  бс  бсбсбс  бс
бс        бс  бсбс  бс  бсбсбсбсбс  бсбсбсбс  бс          бс
бс  бсбс  бс  бсбс  бс  бс      бс            бсбсбс  бс  бс
бс  бсбсбсбс  бс        бс  бс  бсбсбсбс  бс  бс      бс  бс
бс        бс  бсбсбсбсбсбс  бс            бс  бсбс  бсбс  бс
бс  бсбсбсбс          бс    бс  бсбсбсбс  бсбсбс    бс    бс
бс  бс  бс  бс  бсбс  бсбсбсбс  бсбсбсбс  бс      бсбс  бсбс
бс  бс  бс  бс  бс          бс  бсбсбс        бсбсбсбс    бс
бс  бс  бс      бс  бс  бс            бсбсбс        бс  бсбс
бс  бс  бс  бсбсбс  бс  бсбс  бсбсбс  бс  бсбсбсбсбсбс    бс
бс  бс          бс  бс    бсбсбсбсбс  бс  бс        бсбс  бс
бс  бсбсбсбсбс  бс  бсбс            бсбс  бсбсбсбс  бсбс  бс
бс          бс  бс    бс  бсбсбсбс  бсбс  бс        бсбс  бс
бс  бсбсбс  бс  бсбс  бс  бс    бс          бсбсбс        бс
бс  бс      бс  бс    бс  бсбс  бс  бсбсбс        бсбсбс  бс
бс  бс  бсбсбс  бсбс  бс    бс  бс      бс  бсбс  бс  бс  бс
бс  бс  бсбс    бс    бсбс  бс  бсбсбсбсбсбсбсбс  бс      бс
бс  бс      бсбсбсбс  бс        бс                бс  бсбсбс
бс  бсбсбс  бс        бс  бсбс  бс  бсбсбсбсбсбс  бс      бс
бс  бс  бс  бсбсбс  бсбс    бс      бс            бс  бс  бс
бс  бс  бс  бс  бсбсбсбсбсбсбсбсбсбсбсбсбсбсбсбс  бс  бс  бс
бс  бс  бс  бс                            бс  бс  бс  бс  бс
бс  бс  бс      бсбсбсбсбсбсбсбсбсбсбсбс  бс  бс  бс  бсбсбс
бс      бс  бс            бс          бс  бс      бс      бс
бсбсбсбсбс  бсбсбсбсбс  бсбс  бсбсбс  бс  бс  бсбсбс  бс  бс
бс      бс          бс  бсбсбсбс  бс  бс  бс  бс      бс  бс
бс  бс  бсбсбс  бсбс          бс  бс  бс    бсбсбсбс  бсбсбс
бс  бс                бсбсбс  бс      бсбс                бс
бсбсбсбсбсбсбсбсбсбсбсбсбсбсбсбсбсбсбсбсбсбсбсбсбсбсбсбсбсбс
